S.##.....T
#T##..###.
#.###E###E
#...S.###.
#E#T#####G
