S.##.....T
#T##..###.
#.###.###.
#.E...###.
###T#####G
